R 599    599

NO ./images/NO.xpm
SO ./images/SO.xpm
WE ./images/WE.xpm
EA ./images/EA.xpm

S ./images/ITEM.xpm

F 220,100,0
C 225,30,1


        1111111111111111111111111
        1000000000110000000000001
        1011000001110000002000001111
        1111111111111111101111111
                       10001
111111111111111111111111101111111
100000000011000001110111101011111
11110111111111011000000000001
11110111111111000000222000001
1100000011010101100022200N001
10002000000000001000222000001
10000000000000001000000000001
1100000111010111111100000000111
11110111 1110121 101111010001
11111111 1111111 111111111111