R                                       600 600

NO                       ./images/NO.xpm
SO               ./images/SO.xpm
WE                                ./images/WE.xpm
EA                               ./images/EA.xpm

S                 ./images/ITEM.xpm
F             237,201,175
C                     255,255,240

        1111111111111111111111111
        1000000000000000000000021
        1200000000020001111111111
       11100020000020000E1
        11111111111111111111

       11111111111111111
11111111000000000000000111
10000000000000000000000011111
11111111111111110000100000001
10000000000000010000022200001
10000111111111110000010000001
10200000000000000000000000001
10000000000000011111100000001
1001111111000001    100000011
10000021 1000001    100000001
11111111 1111111    111111111
