R 600 600 

NO ./images/NO.xpm
SO ./images/SO.xpm
WE ./images/WE.xpm
EA ./images/EA.xpm

S ./images/ITEM.xpm
F 220,100,0
C 225,30,0

111111111111
100000000001
1000002N0201
111111111111